Comune;Alessandra Todde;Paolo Truzzu;Renato Soru;Lucia Chessa;Total;PRO_COM;pop
ARMUNGIA;100;85;19;0;204;111002;424
ASSEMINI;5396;4004;979;137;10516;92003;25944
BALLAO;106;131;71;1;309;111003;731
BARRALI;145;443;16;0;604;111004;1094
BURCEI;153;1097;34;12;1296;111007;2646
CAGLIARI;37992;24792;7722;1112;71618;92009;148881
CAPOTERRA;5421;3951;677;90;10139;92011;23172
CASTIADAS;288;517;23;8;836;111011;1651
DECIMOMANNU;1858;1381;476;32;3747;92015;8293
DECIMOPUTZU;646;1254;83;11;1994;111013;4164
DOLIANOVA;1521;3159;237;38;4955;111014;9411
DOMUS DE MARIA;247;588;24;1;860;111015;1621
DONORI;394;486;30;5;915;111017;1964
ELMAS;2814;1447;390;47;4698;92108;9358
ESCALAPLANO;473;424;275;8;1180;111018;2079
ESCOLCA;263;69;12;2;346;111019;542
ESTERZILI;91;174;43;2;310;111020;565
GERGEI;308;219;63;2;592;111025;1129
GESICO;168;194;14;1;377;111026;781
GONI;45;171;10;1;227;111029;455
GUAMAGGIORE;150;335;16;3;504;111032;917
GUASILA;677;561;118;8;1364;111033;2482
ISILI;829;520;95;80;1524;111036;2516
MANDAS;481;506;73;7;1067;111039;2009
MARACALAGONIS;1078;2227;187;49;3541;92037;7873
MONASTIR;891;806;157;13;1867;111041;4432
MONSERRATO;4649;3437;650;119;8855;92109;19037
MURAVERA;1047;1250;73;14;2384;111042;5131
NURAGUS;344;75;27;7;453;111045;841
NURALLAO;273;276;69;1;619;111046;1167
NURAMINIS;567;377;114;14;1072;111047;2317
NURRI;519;262;63;10;854;111048;2025
ORROLI;417;508;134;6;1065;111050;2012
ORTACESUS;285;167;11;1;464;111051;881
PIMENTEL;171;343;22;8;544;111055;1126
PULA;1436;1678;123;23;3260;92050;7054
QUARTU SANT'ELENA;14714;12297;2084;323;29418;92051;68430
QUARTUCCIU;2856;2268;475;78;5677;92105;12756
SADALI;107;124;199;0;430;111058;867
SAMATZAI;386;287;43;4;720;111060;1555
SAN BASILIO;184;292;25;0;501;111061;1132
SAN NICOLO' GERREI;125;151;36;1;313;111064;717
SAN SPERATE;1955;1267;377;43;3642;111065;8352
SAN VITO;609;981;78;16;1684;111066;3436
SANT'ANDREA FRIUS;336;392;34;10;772;111069;1709
SARROCH;1240;856;97;17;2210;92066;5033
SELARGIUS;6470;6289;1071;107;13937;92068;28501
SELEGAS;618;166;17;1;802;111074;1292
SENORBI';1011;1147;113;22;2293;111075;4729
SERDIANA;0;0;0;0;0;111076;2647
SERRI;102;151;22;3;278;111079;630
SESTU;3420;3405;520;80;7425;92074;20676
SETTIMO SAN PIETRO;2014;950;191;21;3176;92075;6839
SEULO;278;147;14;3;442;111082;795
SILIQUA;704;697;129;15;1545;111084;3586
SILIUS;0;0;0;0;0;111085;1060
SINNAI;3844;2813;716;62;7435;92080;17172
SIURGUS DONIGALA;302;502;61;5;870;111086;1831
SOLEMINIS;343;455;79;26;903;111087;1840
SUELLI;257;293;13;0;563;111088;1071
TEULADA;675;762;119;10;1566;111089;3293
USSANA;1045;729;132;20;1926;111093;4001
UTA;2129;1439;183;27;3778;92090;8596
VALLERMOSA;307;608;54;12;981;111095;1799
VILLA SAN PIETRO;551;346;34;14;945;92099;2155
VILLANOVA TULO;186;155;86;54;481;111099;1015
VILLAPUTZU;1589;767;98;11;2465;111103;4473
VILLASALTO;187;311;29;3;530;111104;987
VILLASIMIUS;440;1160;181;20;1801;111105;3685
VILLASOR;973;1306;93;21;2393;111106;6554
VILLASPECIOSA;436;779;40;14;1269;111107;2519
BUGGERRU;137;304;67;6;514;111006;1050
CALASETTA;417;773;51;17;1258;111008;2773
CARBONIA;5903;5118;694;86;11801;111009;26390
CARLOFORTE;1786;584;73;18;2461;111010;5953
DOMUSNOVAS;1077;1432;111;18;2638;111016;5886
FLUMINIMAGGIORE;416;590;173;15;1194;111021;2654
GIBA;272;548;42;6;868;111028;1889
GONNESA;865;871;200;185;2121;111030;4674
IGLESIAS;6551;4353;1093;165;12162;111035;25288
MASAINAS;267;319;16;2;604;111040;1217
MUSEI;0;0;0;0;0;111043;1491
NARCAO;476;1069;55;10;1610;111044;3089
NUXIS;240;333;38;6;617;111049;1434
PERDAXIUS;152;667;29;3;851;111054;1310
PISCINAS;105;247;17;1;370;111056;816
PORTOSCUSO;980;1130;134;24;2268;111057;4859
SAN GIOVANNI SUERGIU;1181;1290;173;17;2661;111063;5673
SANT'ANNA ARRESI;405;867;49;8;1329;111070;2628
SANT'ANTIOCO;2586;2284;185;24;5079;111071;10670
SANTADI;388;718;109;8;1223;111068;3156
TRATALIAS;169;291;24;6;490;111090;993
VILLAMASSARGIA;594;769;86;18;1467;111098;3411
VILLAPERUCCIO;106;332;46;3;487;111102;1007
ARBUS;846;1382;241;14;2483;111001;5869
BARUMINI;194;259;58;7;518;111005;1178
COLLINAS;224;134;27;6;391;111012;774
FURTEI;247;473;40;6;766;111022;1527
GENURI;26;164;7;0;197;111024;314
GESTURI;138;461;21;2;622;111027;1153
GONNOSFANADIGA;805;987;279;23;2094;111031;6185
GUSPINI;2303;1635;728;37;4703;111034;11060
LAS PLASSAS;43;52;3;4;102;111037;215
LUNAMATRONA;460;318;62;7;847;111038;1634
PABILLONIS;364;298;248;18;928;111052;2510
PAULI ARBAREI;117;115;16;1;249;111053;565
SAMASSI;811;745;463;20;2039;111059;4817
SAN GAVINO MONREALE;1473;1107;556;25;3161;111062;8119
SANLURI;1145;1953;954;36;4088;111067;8112
SARDARA;691;573;149;14;1427;111072;3824
SEGARIU;454;125;23;0;602;111073;1099
SERRAMANNA;2290;948;514;27;3779;111077;8614
SERRENTI;1172;509;185;13;1879;111078;4557
SETZU;19;42;4;0;65;111080;133
SIDDI;186;89;16;1;292;111083;596
TUILI;124;198;34;1;357;111091;946
TURRI;77;77;33;0;187;111092;391
USSARAMANNA;118;123;34;2;277;111094;493
VILLACIDRO;3120;1764;456;35;5375;111096;13216
VILLAMAR;313;485;136;20;954;111097;2457
VILLANOVAFORRU;93;88;78;2;261;111100;611
VILLANOVAFRANCA;335;160;22;7;524;111101;1194
ARITZO;192;403;43;6;644;91001;1223
ATZARA;178;148;189;8;523;91003;1018
AUSTIS;88;187;30;98;403;91004;767
BELVI';64;222;38;1;325;91007;560
BIRORI;72;93;72;3;240;91008;500
BITTI;349;984;126;75;1534;91009;2597
BOLOTANA;769;247;138;5;1159;91010;2403
BORORE;279;597;88;33;997;91011;1982
BORTIGALI;247;387;55;7;696;91012;1244
DESULO;237;894;42;3;1176;91016;2137
DORGALI;1746;1666;608;55;4075;91017;8299
DUALCHI;183;112;13;1;309;91018;577
FONNI;674;1066;122;63;1925;91024;3696
GADONI;69;264;20;2;355;91025;703
GALTELLI';328;815;102;10;1255;91027;2363
GAVOI;547;637;256;12;1452;91028;2492
IRGOLI;261;613;134;9;1017;91033;2220
LEI;101;120;17;0;238;91038;466
LOCULI;82;161;14;2;259;91040;507
LODE';355;356;20;9;740;91041;1606
LODINE;51;31;113;1;196;91104;306
LULA;225;297;55;2;579;91043;1263
MACOMER;2019;1826;770;44;4659;91044;9410
MAMOIADA;436;854;80;20;1390;91046;2404
MEANA SARDO;183;504;233;10;930;91047;1602
NORAGUGUME;59;66;16;0;141;91050;286
NUORO;9556;5818;2051;324;17749;91051;34105
OLIENA;1475;1902;280;29;3686;91055;6640
OLLOLAI;184;348;94;5;631;91056;1190
OLZAI;155;161;54;7;377;91057;770
ONANI';52;108;15;2;177;91058;371
ONIFAI;107;211;32;7;357;91059;696
ONIFERI;172;207;49;3;431;91060;873
ORANI;680;379;167;43;1269;91061;2706
ORGOSOLO;651;1145;260;27;2083;91062;3950
OROSEI;954;2067;275;25;3321;91063;6765
OROTELLI;448;452;76;2;978;91064;1894
ORTUERI;64;155;396;10;625;91066;1044
ORUNE;435;654;44;16;1149;91067;2150
OSIDDA;38;61;4;0;103;91068;219
OTTANA;449;434;154;2;1039;91070;2195
OVODDA;223;518;132;13;886;91071;1521
POSADA;450;891;82;25;1448;91073;2974
SARULE;332;254;105;13;704;91077;1568
SILANUS;490;541;141;13;1185;91083;2005
SINDIA;214;362;87;4;667;91084;1605
SINISCOLA;2059;2170;570;107;4906;91085;11159
SORGONO;294;459;92;23;868;91086;1515
TETI;106;209;24;5;344;91090;612
TIANA;133;105;29;2;269;91091;444
TONARA;354;516;132;15;1017;91093;1806
TORPE';410;622;67;6;1105;91094;2698
ARZANA;324;754;111;9;1198;91002;2255
BARI SARDO;509;1453;105;8;2075;91005;3830
BAUNEI;1099;495;54;3;1651;91006;3442
CARDEDU;426;410;62;5;903;91103;1923
ELINI;110;163;8;2;283;91019;559
GAIRO;369;281;21;5;676;91026;1293
GIRASOLE;351;379;37;1;768;91031;1326
ILBONO;328;577;58;3;966;91032;1977
JERZU;702;481;83;8;1274;91035;3034
LANUSEI;1115;1039;190;20;2364;91037;5064
LOCERI;392;243;20;3;658;91039;1272
LOTZORAI;521;504;36;9;1070;91042;2093
OSINI;141;123;14;0;278;91069;725
PERDASDEFOGU;486;362;23;4;875;91072;1751
SEUI;197;218;31;1;447;111081;1178
TALANA;100;337;26;7;470;91088;963
TERTENIA;441;1055;113;32;1641;91089;3801
TORTOLI';2409;2659;287;23;5378;91095;10986
TRIEI;238;208;13;0;459;91097;1047
ULASSAI;426;217;36;5;684;91098;1369
URZULEI;237;256;78;2;573;91099;1114
USSASSAI;67;106;22;0;195;91100;472
VILLAGRANDE STRISAILI;681;795;144;6;1626;91101;2947
AGGIUS;358;372;56;5;791;90001;1409
AGLIENTU;155;392;18;5;570;90062;1154
ALA' DEI SARDI;152;803;20;5;980;90002;1764
ARZACHENA;1735;3318;174;37;5264;90006;13331
BADESI;257;563;36;7;863;90081;1825
BERCHIDDA;376;1164;31;5;1576;90009;2630
BORTIGIADAS;278;88;7;3;376;90014;729
BUDDUSO';247;1872;31;1;2151;90017;3622
BUDONI;749;1520;96;31;2396;90091;5298
CALANGIANUS;551;1373;86;33;2043;90021;3814
GOLFO ARANCI;250;892;64;6;1212;90083;2366
LA MADDALENA;1861;1938;525;16;4340;90035;10617
LOIRI PORTO SAN PAOLO;1093;556;41;33;1723;90084;3641
LUOGOSANTO;288;476;17;7;788;90036;1807
LURAS;0;0;0;0;0;90037;2429
MONTI;256;878;66;2;1202;90041;2331
OLBIA;9675;12169;1214;157;23215;90047;60385
OSCHIRI;1007;490;80;3;1580;90049;3037
PADRU;471;477;21;3;972;90090;2040
PALAU;532;766;109;27;1434;90054;4034
SAN TEODORO;925;934;102;18;1979;90092;4941
SANT'ANTONIO DI GALLURA;170;452;14;2;638;90085;1438
SANTA TERESA DI GALLURA;575;1245;202;13;2035;90063;4969
TELTI;424;630;37;5;1096;90080;2222
TEMPIO PAUSANIA;2247;3397;197;88;5929;90070;13278
TRINITA' D'AGULTU E VIGNOLA;491;562;20;5;1078;90074;2210
ABBASANTA;544;597;104;16;1261;95001;2579
AIDOMAGGIORE;176;57;7;1;241;95002;398
ALBAGIARA;102;29;3;1;135;95003;246
ALES;292;320;81;6;699;95004;1285
ALLAI;72;143;10;2;227;95005;355
ARBOREA;494;1086;97;18;1695;95006;3758
ARDAULI;222;132;72;5;431;95007;782
ASSOLO;62;76;31;0;169;95008;348
ASUNI;73;47;13;3;136;95009;311
BARADILI;22;19;3;1;45;95010;75
BARATILI SAN PIETRO;185;249;54;14;502;95011;1206
BARESSA;81;169;13;2;265;95012;566
BAULADU;111;161;33;6;311;95013;649
BIDONI';32;32;4;0;68;95014;127
BONARCADO;102;253;31;4;390;95015;1503
BORONEDDU;51;29;7;0;87;95016;154
BOSA;982;2564;267;31;3844;95079;7465
BUSACHI;287;278;64;5;634;95017;1164
CABRAS;1189;2073;223;30;3515;95018;8760
CUGLIERI;547;459;197;8;1211;95019;2457
CURCURIS;72;61;19;0;152;95077;311
FLUSSIO;53;130;17;4;204;95080;425
FORDONGIANUS;301;139;52;1;493;95020;852
GENONI;77;135;59;2;273;111023;768
GHILARZA;875;1003;234;26;2138;95021;4207
GONNOSCODINA;98;88;23;3;212;95022;435
GONNOSNO';227;92;22;0;341;95023;712
GONNOSTRAMATZA;167;159;40;3;369;95024;809
LACONI;403;341;89;7;840;95082;1673
MAGOMADAS;101;195;24;2;322;95083;582
MARRUBIU;612;1076;243;23;1954;95025;4609
MASULLAS;182;213;101;1;497;95026;1011
MILIS;244;309;69;11;633;95027;1423
MODOLO;36;57;3;1;97;95084;156
MOGORELLA;66;116;13;0;195;95028;410
MOGORO;809;569;217;20;1615;95029;3941
MONTRESTA;44;201;7;3;255;95085;438
MORGONGIORI;79;233;23;3;338;95030;660
NARBOLIA;237;246;207;7;697;95031;1690
NEONELI;237;143;12;2;394;95032;622
NORBELLO;371;177;20;13;581;95033;1115
NUGHEDU SANTA VITTORIA;103;130;5;1;239;95034;441
NURACHI;312;302;67;7;688;95035;1677
NURECI;27;147;9;2;185;95036;319
OLLASTRA;135;392;24;2;553;95037;1131
ORISTANO;5999;6938;1809;181;14927;95038;30541
PALMAS ARBOREA;213;345;72;3;633;95039;1475
PAU;30;74;14;2;120;95040;276
PAULILATINO;347;857;49;8;1261;95041;2087
POMPU;73;51;3;2;129;95042;215
RIOLA SARDO;273;425;73;10;781;95043;2015
RUINAS;65;218;25;1;309;95044;619
SAGAMA;24;56;7;1;88;95086;191
SAMUGHEO;593;556;117;14;1280;95045;2760
SAN NICOLO' D'ARCIDANO;257;886;52;4;1199;95046;2516
SAN VERO MILIS;481;389;152;17;1039;95050;2416
SANTA GIUSTA;659;1339;144;19;2161;95047;4649
SANTU LUSSURGIU;760;274;70;8;1112;95049;2215
SCANO DI MONTIFERRO;272;330;111;5;718;95051;1407
SEDILO;565;526;133;10;1234;95052;1975
SENEGHE;221;294;280;3;798;95053;1676
SENIS;65;100;49;0;214;95054;421
SENNARIOLO;80;29;2;1;112;95055;154
SIAMAGGIORE;155;165;32;1;353;95056;884
SIAMANNA;212;205;23;2;442;95057;772
SIAPICCIA;56;121;4;3;184;95076;344
SIMALA;49;111;12;1;173;95058;283
SIMAXIS;389;469;100;16;974;95059;2124
SINI;107;67;18;0;192;95060;481
SIRIS;62;54;9;1;126;95061;222
SODDI';45;15;0;2;62;95078;120
SOLARUSSA;307;438;221;16;982;95062;2288
SORRADILE;92;62;17;4;175;95063;353
SUNI;117;388;30;2;537;95087;975
TADASUNI;56;20;4;1;81;95064;141
TERRALBA;1546;1997;352;20;3915;95065;9689
TINNURA;33;102;19;2;156;95088;238
TRAMATZA;178;151;35;2;366;95066;936
TRESNURAGHES;143;270;141;5;559;95067;1111
ULA' TIRSO;103;94;6;0;203;95068;469
URAS;408;505;135;12;1060;95069;2682
USELLUS;182;101;18;2;303;95070;727
VILLA SANT'ANTONIO;64;81;11;1;157;95048;331
VILLA VERDE;53;52;8;0;113;95073;288
VILLANOVA TRUSCHEDU;70;66;6;1;143;95071;293
VILLAURBANA;240;625;27;0;892;95072;1491
ZEDDIANI;117;258;48;4;427;95074;1125
ZERFALIU;181;283;17;3;484;95075;1000
ALGHERO;8221;9996;1238;95;19550;90003;42352
ANELA;146;171;13;0;330;90004;584
ARDARA;102;250;19;1;372;90005;736
BANARI;190;40;68;0;298;90007;533
BENETUTTI;579;370;49;4;1002;90008;1704
BESSUDE;120;52;30;1;203;90010;391
BONNANARO;180;248;34;3;465;90011;930
BONO;989;934;57;7;1987;90012;3331
BONORVA;291;1431;176;8;1906;90013;3211
BORUTTA;48;71;24;0;143;90015;260
BOTTIDDA;337;56;18;0;411;90016;649
BULTEI;211;218;25;1;455;90018;841
BULZI;87;136;15;2;240;90019;469
BURGOS;304;193;24;1;522;90020;855
CARGEGHE;186;113;27;0;326;90022;585
CASTELSARDO;1516;1357;107;14;2994;90023;5651
CHEREMULE;65;148;28;2;243;90024;402
CHIARAMONTI;239;510;44;1;794;90025;1511
CODRONGIANOS;272;356;83;1;712;90026;1279
COSSOINE;172;132;57;1;362;90027;762
ERULA;206;141;10;0;357;90088;690
ESPORLATU;131;89;13;2;235;90028;381
FLORINAS;333;311;70;1;715;90029;1442
GIAVE;93;147;19;3;262;90030;493
ILLORAI;187;224;30;2;443;90031;760
ITTIREDDU;86;142;21;3;252;90032;481
ITTIRI;2205;1765;386;6;4362;90033;8069
LAERRU;145;278;8;1;432;90034;859
MARA;170;105;21;1;297;90038;525
MARTIS;104;122;23;0;249;90039;471
MONTELEONE ROCCA DORIA;44;13;3;0;60;90040;109
MORES;265;427;142;0;834;90042;1747
MUROS;229;168;23;0;420;90043;829
NUGHEDU SAN NICOLO';123;301;17;4;445;90044;763
NULE;460;315;29;1;805;90045;1276
NULVI;699;715;51;2;1467;90046;2634
OLMEDO;836;823;165;6;1830;90048;4113
OSILO;603;569;318;11;1501;90050;2826
OSSI;1677;1181;132;9;2999;90051;5462
OZIERI;2033;2608;316;23;4980;90052;9857
PADRIA;108;158;26;3;295;90053;603
PATTADA;626;743;161;1;1531;90055;2880
PERFUGAS;508;472;44;5;1029;90056;2234
PLOAGHE;784;1590;76;3;2453;90057;4348
PORTO TORRES;4774;3000;731;39;8544;90058;21224
POZZOMAGGIORE;401;503;358;7;1269;90059;2399
PUTIFIGARI;214;166;19;0;399;90060;694
ROMANA;91;103;31;1;226;90061;496
SANTA MARIA COGHINAS;141;617;20;3;781;90087;1292
SASSARI;28293;19499;5011;329;53132;90064;121657
SEDINI;269;390;30;1;690;90065;1245
SEMESTENE;27;27;13;0;67;90066;142
SENNORI;1575;1599;172;12;3358;90067;6910
SILIGO;284;102;40;0;426;90068;811
SORSO;2588;3681;297;18;6584;90069;14383
STINTINO;312;340;63;6;721;90089;1535
TERGU;257;100;6;0;363;90086;605
THIESI;373;494;670;14;1551;90071;2796
TISSI;656;377;139;3;1175;90072;2359
TORRALBA;122;419;34;0;575;90073;902
TULA;254;226;290;5;775;90075;1462
URI;820;752;73;5;1650;90076;2837
USINI;990;749;191;14;1944;90077;4222
VALLEDORIA;700;1095;115;7;1917;90079;4218
VIDDALBA;277;522;21;2;822;90082;1611
VILLANOVA MONTELEONE;377;630;101;6;1114;90078;2133
